0003600760
01451004850163000547
00127001010025300221
00004007040036500743
00329008870036501055
00002002230055500304
00479000920055100223
00725000040081500442
00431004470098600487
00195004430032900485
00748006910081201010
00812006900162100748
01341003880170300452
01432001490156000210
01143001410123800202
01177002980129800344
00267000980030200221
00068000950011300219
69696969696969696969