0077000493
00041004260018300491
01489004640160200535
00470000480105000164
00961002070110200276
00855002000087300211
00601002190064900247
01009006780111000777
00383005210047700609
00186001680024000222
01286002340134100300
01345006440142200691
00205007330027200821
00046008210011700898
00536006790068100735
00405002510047600324
00747002520080800296
00744002020076600217
00770003220078300334
00795003510082000375
01143003100120800395
01160005780119700817
00294001890034300297